1 12 0 0 416 3136 32 
1 -2 0 -32 416 32 32
2 11 0 56 475 16 32 
3 11 0 310 475 16 32 
4 11 0 564 475 16 32 
5 11 0 818 475 16 32 
6 11 0 1072 475 16 32 
7 11 0 183 540 16 32 
8 11 0 437 540 16 32 
9 11 0 691 540 16 32 
10 11 0 945 540 16 32 
11 11 0 1208 540 16 32 
12 11 0 1340 672 16 32 
13 11 0 1450 475 16 32 
14 11 0 1590 730 16 32 
15 11 0 1714 672 16 32 
16 11 0 1842 475 16 32 
17 11 0 2092 475 16 32 
18 11 0 2219 475 16 32 
19 11 0 2346 475 16 32 
20 11 0 2473 475 16 32 
21 11 0 2600 475 16 32 
22 11 0 2727 540 16 32
23 11 0 2854 672 16 32
24 11 0 2981 730 16 32
25 12 0 1376 545 96 32
26 12 0 1504 609 320 32
27 12 0 1858 545 192 32 
28 12 0 2784 608 544 32 
29 0 0 3056 448 32 160 
30 0 0 3056 736 32 32
31 12 0 3328 545 96 32 
32 12 0 3198 416 384 32 
33 12 0 3712 416 96 32 
34 12 0 3712 577 64 32 
35 12 0 3776 545 96 32 
36 0 0 3584 416 128 192
37 12 0 3907 608 416 32 
38 12 0 3856 416 1760 32 
39 12 0 4352 545 352 32 
40 12 0 5537 545 96 32 
41 12 0 5441 480 64 32 
42 11 0 3755 475 16 32 
43 11 0 3666 686 16 32
44 11 0 3892 706 16 32 
45 11 0 4037 690 16 32 
46 11 0 4125 584 16 32 
47 11 0 4275 665 16 32 
48 11 0 4404 610 16 32 
49 11 0 4535 656 16 32 
50 11 0 4690 490 16 32 
51 11 0 4785 540 16 32 
52 11 0 4921 475 16 32 
52 11 0 5048 475 16 32 
52 11 0 5175 555 16 32 
52 11 0 5302 475 16 32 
52 11 0 5429 555 16 32 
1 13 0 1248 448 32 32 
1 -13 0 1248 448 64 32
1 13 0 1280 480 32 32 
1 13 0 1312 512 32 32 
1 13 0 1344 544 32 32 
1 -14 0 1328 635 64 32 
1 13 0 1438 576 32 32 
1 -13 0 1438 576 64 32
1 13 0 1470 608 32 32 
1 -14 0 1504 695 64 32 
-1 13 0 1820 608 32 32 
-1 13 0 1852 576 32 32 
-1 -13 0 1884 576 64 32
-1 -14 0 1788 700 64 32
1 13 0 2589 448 32 32 
1 13 0 2621 480 32 32 
1 13 0 2653 512 32 32 
1 13 0 2685 544 32 32 
1 13 0 2717 576 32 32 
1 13 0 2749 608 32 32 
1 -13 0 2589 448 64 32
1 -14 0 2749 700 32 32 
-1 13 0 3521 448 32 32 
-1 13 0 3489 480 32 32 
-1 13 0 3457 512 32 32 
-1 13 0 3425 544 32 32 
-1 -13 0 3553 448 64 32
-1 -14 0 3392 610 32 32 
1 1 0 500 500 0 0